WWWWWWWWWWWWWWWWWWWWWWWWWWWWWWWWWWWWWWWW
WD                                     W
WWWWWWWWWWWWWWWWWWWWWWWWWWWWWWWWWWWWWW W
W                                      W
W WWWWWWWWWWWWWWWWWWWWWWWWWWWWWWWWWWWWWW
W abcdefghijklmnopqrftuvwxyz           W
W                                      W
W WWWWWWWWWWWWWWWWWWWWWWWWWWWWWWWWWWWWWW
W                                      W
WWWWWWWWWWWWWWWWWWWWWWWWWWWWWWWWWWWWWW W
W                                      W
W WWWWWWWWWWWWWWWWWWWWWWWWWWWWWWWWWWWWWW
W                                      W
WWWWWWWWWWWWWWWWWWWWWWWWWWWWWWWWWWWWW  W
W                                      W
W WWWWWWWWWWWWWWWWWWWWWWWWWWWWWWWWWWWWWW
W                                    C W
WWWWWWWWWWWWWWWWWWWWWWWWWWWWWWWWWWWWWWWW